10 10
##########
# |    k #
#k###-##-#
# #   #  #
# ### ## #
#-### ## #
# ##e ## #
# ########
# k     s#
##########